   F   56 , 1 ,      00254
C 112,112,112
    NO     ./textures/redbrick.xpm
SO ./textures/greystone.xpm
WE ./textures/mossy.xpm
EA ./textures/bluestone.xpm  




111111111111111111111111111111111
1000000000000000000000000N0000001
100000000000000000000000000000001
100000000000000000000000000000001
100000000000000000000000000000001
100000000000000000000000000000001
100000000000000000000000000000001
100000000000000000000000000000001
100000000000000000000000000000001
100000000000000000000000000000001
100000000000000000000000000000001
100000000000000000000000000000001
100000000000000000000000000000001
100000000000000000000000000000001
100000000000000000000000000000001
100000000000000000000000000000001
100000000000000000000000000000001
100000000000000000000000000000001
111111111111111111111111111111111
